0,0,0,0,0,0,0,2,0,2,2,2,2,1,0,0,
0,0,0,0,0,2,2,2,2,2,2,2,2,1,1,0,
0,0,0,0,2,10,2,2,2,2,2,2,2,1,1,0,
0,0,0,2,2,2,2,2,2,1,1,1,1,1,1,0,
0,0,1,1,1,1,1,1,1,1,1,1,1,1,1,1,
0,1,1,1,1,1,1,1,1,1,1,1,10,1,1,10,
0,1,1,1,1,1,1,1,3,3,1,1,1,1,1,1,
0,1,1,10,1,1,1,3,10,3,3,1,1,1,1,1,
0,0,0,1,1,1,1,3,3,3,3,1,1,1,1,1,
0,0,1,1,1,1,1,3,3,1,1,1,1,0,0,0,

